11111111111111111111111111111111111111111
1010000E000000000000000000000001010000111
100C0101001000001010010000000101010000111
1P100100111010100010010000000101010000111
10010000111000000000000000000101010000111
10100101111000001010010000000101000000111
10000000000000001000000000000001110000111
11111111111111111111111111111111111111111
