11111111111111111111111111111111111111111
10100000000000000000000000000001010000001
10000101001000001010010000000101010000001
10101001110101000100100000000101010000001
10P10000001000000000000000000101010000001
10100101101000001010010000000101000000001
100000000C0000001000C00E00000001110000001
11111111111111111111111111111111111111111










