1111111111111111111111111111111111
100000000000000C00000C000000E00001
1010010100100000101001000000010101
1010010010101010000011111100010101
101000000C00C00000000000P1000000C1
1111111111111111111111111111111111
