11111
1PC01
11111
10E01
11111
